00000000000000000000000000000000000000000000000000
00000000000000000000001111111111100000000000000000
00000000000000000000111111110000000000000000000000
00000000000000000000111111110000000000000000000000
00000000000000000000000000000000000000000000000000
00000000000000000000000000000011111111111000000000
00000000000000000000000000000011111111111000000000
00000000000000000000000000000011111111111000000000
00000000000000000000000000000011111111111000000000
00000000000000000000000000000000000000000000000000
00000000000000000000000000000000000000000000000011
00000000000000000000000000000000000000000000000011
00000000000000000000000000000000000000000000000011
00000000000000000000000000000000000000000000000000
00000000000000000000000000000000000000000000000000
00000000001111101111110000000000000000000000000000
00000000111111101111111100000000000000000000000000
00000000111111101111111100000000000000000000000000
00000000111111101111111100000000000000000000000000
00000000001111101111110000000000000000000000000000
00000000000000000000000000000000000000000000000000
00000000000000000000000000000000000000000000000000
00000000000000000000000000000000000000000000000000
00000000000000000000000000000000111111000000000000
00000000000000000000000000000001111111100000000000
00000000000000000000000000000011111111110000000000
00000000000000000000000000000011111111110000000000
00000000000000000000000000000001111111100000000000
00000000011111110000000000000000111111000000000000
00000000011111110000000000000000000000000000000000
00000000011111110000000000000000000000000000000001
00000000011111110000000000000000000000000000000011
00000000000000000000000000000000000000000000000111
00000000000000000000000000000000000000000000001111
00000000000000000000000000000000000000000000000111
11111100000000000000000111111111111111100000000011
00000000000000000000000111111111111111100000000001
00000000000000000000000001111100000000000000000000
00000000000000000000000001111100000000000000000000
00000000000000000000000001111100000000000000000000
00000000000000000000000111111111111111100000000000
00000000000000000000000111111111111111100000000000
00000000000000000000000000000000000000000000000000
00000000000000000000000000000000000000000000000000
11111110000000000000000000000000000000000000000000
11111110000000000000000000000000000000000000000000
11111110000000000000000000000000000000000000000000
00000000000000000000000000000000000000000000000000
00000000000000000000001111111111111000000000000000
00000000000000000000000000000000000000000000000000